10;10
1010101010
0000000000
0101010101
0000000000
1010101010
0000000000
0101010101
0000000000
1010101010
0000000000
