15;15
000000000000000
000000000000000
000000000000000
000000000000000
101000100010100
101001010010100
111001110010100
101010001010000
101010001010100
000000000000000
000000000000000
000000000000000
000000000000000
000000000000000
000000000000000
