15;15
000000000000000
000000000000000
000000000000000
000000000000000
000000000000000
000000000000000
000001110000000
000001010000000
000001110000000
000001010000000
000001110000000
000000000000000
000000000000000
000000000000000
000000000000000
