10;10
0000100000
0010100100
1000010000
1000010100
0000000000
0010011000
0000000000
0100100001
0000000000
0000000000
