15;15
000000010001101
000100101000010
000000010000000
001010100000100
000000010001100
000000000001000
000000010000000
001001011000001
000000010000000
000000100000010
001001010000010
000000000100001
001001000000101
010000110101000
000000100000001
